// 맵 가로(XTile : 16), 세로(YTile : 10) 
// 'G' : 배경 
// '#' : 벽
// 'B' : 박스
// '@' : 사람
// '.' : 도착점
// ' ' : 길
// //으로 메모장에 주석을 남길 수 있습니다.

################
G##############G
G#####     ####G
G##         ###G
G##  @B.   ####G
G##   B.  #####G
G##       #####G
G##### ########G
G##############G
################

################
GGGGGGGGGGGGGGGG
G#####     ####G
G##         ###G
G##  @B.   ####G
G##   B.  #####G
G##       #####G
G##### ########G
G##############G
################

################
################
G#####     ####G
G##         ###G
G##  @B.   ####G
G##   B.  #####G
G##       #####G
G##### ########G
GGGGGGGGGGGGGGGG
################