GGGGGGGGGGGGGGGG
G##############G
G#####     ####G
G##         ###G
G##  @B.   ####G
G##   B.  #####G
G##       #####G
G##### ########G
G##############G
GGGGGGGGGGGGGGGG

GGGGGGGGGGGGGGGG
G##############G
G#####     ####G
G##         ###G
G##  @B.   ####G
G##   B.  #####G
G##       #####G
G##### ########G
G##############G
GGGGGGGGGGGGGGGG

